180,410,640,260,260,560,560,460,360,360,460

250,160,250,250,600,250,600,600,600,500,500

0,1,0,1,0,0,0,0,0,0,0
1,0,1,0,0,0,0,0,0,0,0
0,1,0,0,0,1,0,0,0,0,0
1,0,0,0,1,1,0,0,0,0,0
0,0,0,1,0,0,0,0,1,0,0
0,0,1,1,0,0,1,0,0,0,0
0,0,0,0,0,1,0,1,0,0,0
0,0,0,0,0,0,1,0,0,0,1
0,0,0,0,1,0,0,0,0,1,0
0,0,0,0,0,0,0,0,1,0,1
0,0,0,0,0,0,0,1,0,1,0