170,400,630,170,400,630,400,400,265,535

170,170,170,630,630,630,530,270,385,385

0,1,0,1,0,0,0,0,0,0
1,0,1,0,0,0,0,1,0,0
0,1,0,0,0,1,0,0,0,0
1,0,0,0,1,0,0,0,0,0
0,0,0,1,0,1,1,0,0,0
0,0,1,0,1,0,0,0,0,0
0,0,0,0,1,0,0,1,1,1
0,1,0,0,0,0,1,0,1,1
0,0,0,0,0,0,1,1,0,0
0,0,0,0,0,0,1,1,0,0