400,300,250,200,470,580,610,440,620,430

500,500,350,200,170,190,290,310,350,430

0,2,0,0,0,0,0,0,0,0
2,0,2,0,0,0,0,0,0,0
0,2,0,1,0,0,0,0,0,1
0,0,1,0,1,0,0,0,0,0
0,0,0,1,0,1,0,1,0,0
0,0,0,0,1,0,1,0,0,0
0,0,0,0,0,1,0,1,0,0
0,0,0,0,1,0,1,0,1,1
0,0,0,0,0,0,0,1,0,0
0,0,1,0,0,0,0,1,0,0