300,500,635,400,165,330,470,520,400,280

635,635,350,165,350,350,350,460,550,460

0,1,0,0,1,0,0,0,1,1
1,0,1,0,0,0,0,1,1,0
0,1,0,1,0,0,1,1,0,0
0,0,1,0,1,1,1,0,0,0
1,0,0,1,0,1,0,0,0,1
0,0,0,1,1,0,1,0,0,1
0,0,1,1,0,1,0,1,0,0
0,1,1,0,0,0,1,0,1,0
1,1,0,0,0,0,0,1,0,1
1,0,0,0,1,1,0,0,1,0